...###....
..##.#.###
..#..###..
..........
#...@..#..
###..#.#..
..#..#....
.##.##.#.#
........##
.#........
.#######..